A M T V L
R O L A D
I I N I E
N I P G U
K H U S O